4,0,4,4,4,4,4,4,4,4,4,4,1,4,,
4,2,4,4,4,4,4,4,4,4,4,4,3,4,,
4,0,4,4,4,4,4,4,4,4,4,4,1,4,,
4,2,4,4,4,4,4,4,4,4,4,4,3,4,,
4,0,4,4,9,4,4,4,4,4,4,4,1,4,,
4,2,4,4,4,4,4,4,4,4,4,4,3,4,,
4,0,4,4,4,4,4,4,9,4,4,4,1,4,,
4,2,4,4,4,4,4,4,4,4,4,4,3,4,,
4,0,4,4,4,4,4,4,4,4,4,4,1,4,,
4,2,4,4,4,10,4,4,4,4,4,4,3,4,,
4,2,63,57,60,57,63,57,63,57,57,63,60,4,,
